nombrecompleto,CostoPasajes,CostoViaticos,CantidadViajes,TotalViaje,CostoPerViaje,Institución
Aaron Gonzalez,1972,2100,1,4072,4072,Ministerio de la Presidencia
Abdias Slatér,0,2520,1,2520,2520,MEF
Abdiel Bethancourt,0,10860,2,10860,5430,MITRADEL
Abdiel Patiño,0,6900,2,6900,3450,Ministerio de la Presidencia
Abdul Rodriguez,0,4800,2,4800,2400,Ministerio de Seguridad Pública
Abel Barrías,0,630,1,630,630,Ministerio del Ambiente
Abelardo Muñoz,0,4500,1,4500,4500,Ministerio de Seguridad Pública
Abraham Bozo,609,0,1,609,609,Ministerio de la Presidencia
Abraham Herrera,700,11700,12,12400,1033,Ministerio del Ambiente
Adalina Campos,1306,1875,5,3181,636,MEF
Adelizabeth Rodriguez,7085,18000,3,25085,8362,Ministerio de la Presidencia
Adolfo Martinez,699,0,1,699,699,Ministerio de la Presidencia
Adriana Chung,0,900,2,900,450,MINSA
Adriana Correa,2542,2400,1,4942,4942,MICI
Agustín Corrales,2500,6000,1,8500,8500,Ministerio del Ambiente
Agustin Ordoñez,0,2490,2,2490,1245,MINSA
Agustín Rodríguez,0,3435,2,3435,1718,Ministerio del Ambiente
Agustin Saldaña,0,1050,1,1050,1050,MINSA
Aida Arias,0,1755,2,1755,878,MEF
Aida Batista,1500,1305,2,2805,1403,MIDES
Aída Martínez,0,315,4,315,79,ANTAI
Aixa Jaramillo,1217,4200,1,5417,5417,MEF
Alan Rivier,0,1050,1,1050,1050,MINSA
Alba Bravo,501,1600,1,2101,2101,MOP
Alberto Alemán,2717,7600,4,10317,2579,MICI
Alberto Delgado,690,3000,1,3690,3690,Ministerio de la Presidencia
Alberto Lo Polito,1462,6553,2,8015,4007,MITRADEL
Alberto Prestán,1257,2700,1,3957,3957,MEF
Alberto Rangel,0,2100,1,2100,2100,MINSA
Aldacira Bradshaw,0,400,1,400,400,MINSA
Alejandra Pérez,0,4140,1,4140,4140,MEF
Alejandro Lasso,0,6800,2,6800,3400,MITRADEL
Alejandro Melo,952,4870,3,5822,1941,Ministerio de la Presidencia
Alejandro Mendoza,0,5400,1,5400,5400,MITRADEL
Alejandro Tuñon,1512,4300,3,5812,1937,Ministerio de la Presidencia
Alejandro Vernaza,1758,5850,1,7608,7608,MEF
Alex Cruz,0,1750,1,1750,1750,Ministerio del Ambiente
Alex De Gracia,0,6300,3,6300,2100,Ministerio del Ambiente
Alex Montenegro,2774,3325,3,6099,2033,Ministerio de la Presidencia
Alex Perez,67360,38550,17,105910,6230,Ministerio de la Presidencia
Alex Van Der Hans,0,2000,1,2000,2000,AIG
Alex Villa,0,5200,3,5200,1733,Ministerio de Seguridad Pública
Alexa Espino,2030,12135,5,14165,2833,MITRADEL
Alexander Montero,0,1335,4,1335,334,Ministerio del Ambiente
Alexander Santoya,9099,24200,10,33299,3330,MICI
Alexia Soto,0,9600,1,9600,9600,Ministerio de Seguridad Pública
Alexis Almanza,256,7200,3,7456,2485,Ministerio de Seguridad Pública
Alexis Bethancourt,9383,27860,13,37243,2865,Ministerio de la Presidencia
Alexis Pineda,3824,6200,4,10024,2506,MICI
Alexis Quiroz,0,500,1,500,500,Ministerio del Ambiente
Alexis Rodríguez,0,19190,7,19190,2741,Ministerio del Ambiente
Alfonso Quirós,0,4230,2,4230,2115,MIDES
Alfonso Serrano,0,300,2,300,150,Ministerio del Ambiente
Alfredo Molto,0,300,1,300,300,MINSA
Alfredo Peña,0,2400,1,2400,2400,Ministerio de Seguridad Pública
Alfredo Suescum,2715,2850,3,5565,1855,MICI
Alibis Herrera,645,630,1,1275,1275,MEF
Alina Rodriguez,0,630,1,630,630,Ministerio del Ambiente
Alis Mosquera,2561,2700,1,5261,5261,Ministerio de la Presidencia
Aljedrando Varela,800,0,1,800,800,Ministerio de la Presidencia
Alma González,0,315,1,315,315,MEF
Alvaro Aleman,918,900,2,1818,909,Ministerio de la Presidencia
Alvaro Lozano,2449,3925,2,6374,3187,MINSA
Alvaro Montenegro,2115,9150,3,11265,3755,MEF
Alvaro Sánchez,0,5160,3,5160,1720,Ministerio del Ambiente
Alvaro Varela,0,1200,1,1200,1200,Ministerio de Seguridad Pública
Alvaro Ventura,0,4000,1,4000,4000,Ministerio de Seguridad Pública
Alvin Alvarado,0,500,1,500,500,Ministerio de Seguridad Pública
Alvin Alzamora,0,3150,1,3150,3150,Ministerio del Ambiente
Amanda Edith,0,600,1,600,600,Ministerio de Seguridad Pública
Amed Arosemena,1362,6750,2,8112,4056,MITRADEL
Ameth Barria,0,2500,1,2500,2500,Ministerio de Seguridad Pública
Ameth Cerceño,0,720,1,720,720,MINSA
Ameth Perez,4428,5400,1,9828,9828,Ministerio de la Presidencia
Ameth Sanchez,1972,2100,1,4072,4072,Ministerio de la Presidencia
Ana Aguilar,0,16165,11,16165,1470,Ministerio del Ambiente
Ana Alfonso,5955,13200,6,19155,3193,MICI
Ana Candanedo,0,300,1,300,300,Ministerio del Ambiente
Ana Carmen,0,1530,2,1530,765,Ministerio del Ambiente
Ana Castillo,8451,0,2,8451,4226,Ministerio de la Presidencia
Ana Concepción,0,1700,3,1700,567,Ministerio del Ambiente
Ana Cristina,0,660,1,660,660,MIDES
Ana De León,30094,11850,7,41944,5992,Ministerio de la Presidencia
Ana Domínguez,0,15520,4,15520,3880,Ministerio del Ambiente
Ana Gonzalez,0,270,1,270,270,MINSA
Ana Henríquez,999,2000,1,2999,2999,MICI
Ana Lopez,0,10400,5,10400,2080,Ministerio del Ambiente
Ana Reyes,4554,10250,6,14804,2467,Ministerio de la Presidencia
Ana Rodríguez,0,630,1,630,630,Ministerio del Ambiente
Ana Saucedo,1365,0,1,1365,1365,MINSA
Ana Tuñón,0,7425,4,7425,1856,Ministerio del Ambiente
Anabel Broce,1849,3000,1,4849,4849,AIG
Anadela Del Cid,673,2450,1,3123,3123,MEF
Anarella Jaen,0,6200,5,6200,1240,MINSA
Anastacio González,0,630,1,630,630,Ministerio del Ambiente
Anayansi Lobo,1022,2700,1,3722,3722,MEF
Anayansi Tejada,0,300,1,300,300,MINSA
Andrea Garzón,2750,0,1,2750,2750,MEF
Andy Monrroy,0,6800,2,6800,3400,MITRADEL
Angel Araúz,0,525,2,525,263,Ministerio del Ambiente
Angel Calderon,719,0,1,719,719,Ministerio de la Presidencia
Ángel Martínez,0,2415,1,2415,2415,MITRADEL
Ángel Mudarra,1106,2415,2,3521,1761,MEF
Angel Rangel,1251,2160,1,3411,3411,MEF
Angel Rodriguez,0,4800,2,4800,2400,Ministerio de Seguridad Pública
Ángel Valdespino,0,6800,2,6800,3400,MITRADEL
Ángela Jiménez,0,525,1,525,525,Ministerio del Ambiente
Angela Romero,3188,9900,3,13088,4363,MEF
Angélica Maytín,53808,51800,14,105608,7543,ANTAI
Angelo Gutierrez,3572,6700,3,10272,3424,MICI
Angely Véliz,0,500,1,500,500,Ministerio del Ambiente
Aniano Pinzón,0,9600,1,9600,9600,MITRADEL
Aníbal Nicholson,960,2800,2,3760,1880,MICI
Anibal Ortiz,0,1050,1,1050,1050,MINSA
Anibal Ruiz,972,1600,1,2572,2572,Ministerio de la Presidencia
Annie Domingo,0,420,1,420,420,MEF
Annjanette Vergara,0,3500,1,3500,3500,Ministerio de Seguridad Pública
Anthony Vega,0,720,2,720,360,Ministerio del Ambiente
Antonella Finis,0,2000,1,2000,2000,Ministerio del Ambiente
Antonio Corro,0,6800,2,6800,3400,MITRADEL
Antonio Lam,19003,42720,12,61723,5144,ANTAI
Antonio Velasquez,1115,2100,1,3215,3215,MIDES
Aquiles Medina,800,4300,4,5100,1275,Ministerio de Seguridad Pública
Aquino Rodríguez,0,315,1,315,315,MEF
Aracelis Arosemena,2398,8830,5,11228,2246,MINSA
Aracelis Casanova,0,5400,2,5400,2700,Ministerio de Seguridad Pública
Aracelis Guardia,0,6800,2,6800,3400,MITRADEL
Aracelis Vergara,0,400,1,400,400,MINSA
Aracely Méndez,0,12170,13,12170,936,MEF
Arelis Álvarez,1872,5700,2,7572,3786,MEF
Arelis Quintero,2360,9870,7,12230,1747,MINSA
Arelys Fuentes,0,5520,12,5520,460,Ministerio del Ambiente
Ariadnny Guevara,950,7175,10,8125,813,Ministerio del Ambiente
Ariel Gómez,0,3400,1,3400,3400,MITRADEL
Ariel Moraleas,0,3300,1,3300,3300,MICI
Aris Escobar,0,4635,4,4635,1159,Ministerio del Ambiente
Aris Ramos,0,500,1,500,500,MINSA
Aristides Abrego,0,4800,2,4800,2400,Ministerio de Seguridad Pública
Aristides Valdonedo,1825,4200,1,6025,6025,MEF
Armando Aparicio,2223,3900,1,6123,6123,Ministerio de la Presidencia
Armando Barba,0,400,1,400,400,MINSA
Armando Osorio,0,300,2,300,150,Ministerio de la Presidencia
Arquimedes Berroa,0,3150,1,3150,3150,MINSA
Arturo Rebollon,0,750,1,750,750,MINSA
Astrid Castroverde,1386,4665,2,6051,3025,MITRADEL
Astrid Tejada,0,2250,1,2250,2250,Ministerio de la Presidencia
Atala Milord,0,500,1,500,500,MINSA
Augusto Arosemena,42974,18125,9,61099,6789,MICI
Augusto Diaz,0,300,1,300,300,MINSA
Aura Teleguario,1179,0,1,1179,1179,Ministerio de la Presidencia
Aurelio Gracia,0,0,1,0,0,Ministerio del Ambiente
Aurelio Linero,0,11000,2,11000,5500,MITRADEL
Aurelio Nuñez,718,5950,13,6668,513,MINSA
Aurora Carreiro,2600,1980,2,4580,2290,MIDES
Avelino Cardenas,623,700,1,1323,1323,Ministerio de la Presidencia
Aziza Ladrón,0,0,1,0,0,Ministerio del Ambiente
Balbino Quintana,0,4800,2,4800,2400,Ministerio de Seguridad Pública
Barbara Sanhueza,915,0,1,915,915,Ministerio de la Presidencia
Barry Arce,0,1050,1,1050,1050,MINSA
Beatriz Manzur,724,6000,3,6724,2241,MITRADEL
Beatriz Melendez,1200,2000,1,3200,3200,MIDES
Bedsy González,0,420,2,420,210,Ministerio del Ambiente
Belinda Castroverde,1200,2000,1,3200,3200,Ministerio de Seguridad Pública
Belisario Tejada,697,4500,2,5197,2599,Ministerio de Seguridad Pública
Belkis Oberto,0,6800,2,6800,3400,MITRADEL
Benigno Villamonte,0,3570,4,3570,893,Ministerio del Ambiente
Benito Gómez,0,1750,1,1750,1750,Ministerio del Ambiente
Berta Diaz,0,1600,1,1600,1600,Ministerio de Seguridad Pública
Betsy Castro,1912,4450,2,6362,3181,MEF
Bilibal Navarrete,0,1260,2,1260,630,Ministerio del Ambiente
Billy Bonini,0,420,1,420,420,Ministerio del Ambiente
Blanca Solís,0,630,1,630,630,MEF
Bolivar Jaén,0,3635,6,3635,606,Ministerio del Ambiente
Bolívar Pérez,928,1450,1,2378,2378,Ministerio del Ambiente
Boris Quintero,0,420,1,420,420,MEF
Braulio Correa,0,0,1,0,0,Ministerio del Ambiente
Braulio Rodríguez,0,2520,1,2520,2520,MEF
Caleb Escudé,0,1080,1,1080,1080,MEF
Camilo Caballero,2115,6900,2,9015,4508,MEF
Camilo Samaniego,0,1225,2,1225,613,Ministerio del Ambiente
Carla Bush,972,0,1,972,972,Ministerio de la Presidencia
Carla Ruiz,2792,3000,1,5792,5792,AIG
Carla Vásquez,0,315,1,315,315,MEF
Carla White,972,0,1,972,972,Ministerio de la Presidencia
Carlamara Sánchez,1143,2000,1,3143,3143,MEF
Carlos Arauz,0,1365,1,1365,1365,Ministerio del Ambiente
Carlos Coronado,0,2400,1,2400,2400,Ministerio de Seguridad Pública
Carlos Damian,0,1050,1,1050,1050,Ministerio de la Presidencia
Carlos Diaz,1988,4455,3,6443,2148,AIG
Carlos Duboy,14811,11200,7,26011,3716,Ministerio de la Presidencia
Carlos Galvez,0,540,2,540,270,MINSA
Carlos Garrido,3540,4350,4,7890,1972,Ministerio de la Presidencia
Carlos Gómez,0,28090,23,28090,1221,Ministerio del Ambiente
Carlos González,0,400,1,400,400,Ministerio del Ambiente
Carlos Iglesias,401,2015,3,2416,805,Ministerio de la Presidencia
Carlos Jaen,0,0,1,0,0,MOP
Carlos Lopez,0,400,1,400,400,MINSA
Carlos Melgarejo,0,1830,3,1830,610,Ministerio del Ambiente
Carlos Membreño,0,2400,1,2400,2400,MITRADEL
Carlos Mirones,0,2400,1,2400,2400,Ministerio de Seguridad Pública
Carlos Moreno,0,600,1,600,600,Ministerio del Ambiente
Carlos Nieto,0,6800,2,6800,3400,MITRADEL
Carlos Núñez,388,5915,3,6303,2101,MITRADEL
Carlos Peralta,878,2100,1,2978,2978,MINSA
Carlos Ramea,0,3000,1,3000,3000,Ministerio de Seguridad Pública
Carlos Samudio,0,420,1,420,420,MITRADEL
Carlos Sánchez,0,2775,5,2775,555,Ministerio del Ambiente
Carlos Santos,0,0,1,0,0,MOP
Carlos Vásquez,0,630,2,630,315,Ministerio del Ambiente
Carlos Vergara,1365,8400,1,9765,9765,Ministerio de la Presidencia
Carlos Victoria,0,1100,2,1100,550,MINSA
Carmela Jackman,0,600,1,600,600,MINSA
Carmen Arosemena,0,810,1,810,810,MEF
Carmen Arritola,0,0,1,0,0,MITRADEL
Carmen De La Soledad,1102,0,1,1102,1102,Ministerio de la Presidencia
Carmen Diaz,782,0,1,782,782,Ministerio de la Presidencia
Carmen Galvez,0,540,1,540,540,MINSA
Carmen Gomez,0,4800,1,4800,4800,Ministerio de la Presidencia
Carmen Medina,0,1870,4,1870,468,Ministerio del Ambiente
Carmen Prieto,0,945,2,945,473,Ministerio del Ambiente
Carmen Roner,3444,5050,4,8494,2123,MITRADEL
Carmen Vega,0,525,1,525,525,MEF
Carmen Zorita,4270,10635,4,14905,3726,MEF
Carolina Wong,0,930,2,930,465,Ministerio del Ambiente
Cecilio Cedalise,0,6260,3,6260,2087,MITRADEL
Cecilio Fuentes,763,1200,1,1963,1963,MINSA
Cecilio Tejeira,1440,6425,6,7865,1311,MINSA
Celia Luque,0,3600,1,3600,3600,MINSA
Celina Calderon,0,2400,1,2400,2400,Ministerio de Seguridad Pública
Celina Denys,596,0,1,596,596,Ministerio de la Presidencia
Celso Ramos,0,2400,1,2400,2400,Ministerio de Seguridad Pública
Cesar Ayala,0,3375,1,3375,3375,MINSA
Cesar Corro,1673,4200,1,5873,5873,MEF
Cesar Cubilla,0,0,1,0,0,MINSA
Cesar Morant,1366,800,1,2166,2166,MINSA
Christian Arrocha,1646,2340,2,3986,1993,MEF
Christian Vega,0,8300,4,8300,2075,Ministerio de Seguridad Pública
Cielo O'neill,952,2375,2,3327,1664,Ministerio de Seguridad Pública
Cinia Lebron,0,750,1,750,750,Ministerio de Seguridad Pública
Clifford Green,671,2485,3,3156,1052,MEF
Constantino Smith,0,3150,1,3150,3150,Ministerio del Ambiente
Coralia Sanchez,0,8400,1,8400,8400,MINSA
Corina Sucre,1386,2880,2,4266,2133,MEF
Cosme Moreno,2300,3030,2,5330,2665,MIDES
Cristina Gomez,0,1020,2,1020,510,MINSA
Cristina Santos,0,0,1,0,0,MINSA
Cristina Silvera,1366,800,1,2166,2166,MINSA
Cristobal Madrid,585,3200,1,3785,3785,MOP
Crys Camaño,0,0,1,0,0,MOP
Cynthia Deville,3500,13320,6,16820,2803,Ministerio del Ambiente
Cynthia Murgas,0,3750,2,3750,1875,Ministerio del Ambiente
Cynthia Sánchez,0,6400,2,6400,3200,MITRADEL
Dalia Vargas,0,5955,5,5955,1191,Ministerio del Ambiente
Dalys Ortega,2378,6000,2,8378,4189,Ministerio de la Presidencia
Dalys Pinto,0,900,2,900,450,MINSA
Daniel Arroyo,0,1500,1,1500,1500,Ministerio de Seguridad Pública
Daniel Cedeño,461,6900,2,7361,3681,MINSA
Daniel Pareja,0,945,1,945,945,Ministerio del Ambiente
Daniel Quezada,1785,4950,2,6735,3368,MITRADEL
Daniel Thompson,0,8500,2,8500,4250,Ministerio de Seguridad Pública
Daniel Vega-ayala,895,3150,1,4045,4045,MEF
Danis Mack,0,400,1,400,400,MINSA
Danya Vásquez,0,7800,1,7800,7800,Ministerio del Ambiente
Dario Castillo,1207,2100,1,3307,3307,MEF
Darío Luque,0,10340,16,10340,646,Ministerio del Ambiente
Daris Domínguez,0,525,1,525,525,Ministerio del Ambiente
Darma Romero,776,6600,1,7376,7376,MEF
Darren Delgado,0,2400,1,2400,2400,Ministerio de Seguridad Pública
David Cortez,0,315,1,315,315,MINSA
David Díaz,1800,7680,8,9480,1185,Ministerio del Ambiente
David Hidalgo,3976,7280,4,11256,2814,MEF
David Luke,3853,1800,1,5653,5653,Ministerio de la Presidencia
David Montenegro,3572,7155,8,10727,1341,Ministerio de la Presidencia
David Muñoz,3623,7700,5,11323,2265,Ministerio de la Presidencia
David Quiros,3929,10200,3,14129,4710,Ministerio de la Presidencia
David Rojas,972,0,1,972,972,Ministerio de la Presidencia
David Young,8340,17550,4,25890,6473,Ministerio de la Presidencia
Dayanara Barría,443,1600,1,2043,2043,MITRADEL
Dayara Martinez,0,735,2,735,368,MINSA
Dayra Samaniego,0,1575,2,1575,788,Ministerio del Ambiente
Daysi González,0,210,1,210,210,Ministerio del Ambiente
Daysi Vargas,0,17670,7,17670,2524,Ministerio del Ambiente
De Mosqueras,0,200,1,200,200,MITRADEL
Delfina Vidal,1448,9600,2,11048,5524,MITRADEL
Delvis Mojica,0,0,1,0,0,Ministerio del Ambiente
Denis Espinosa,266,630,1,896,896,MEF
Denis Montenegro,0,6015,4,6015,1504,MITRADEL
Denis Ziñiga,0,525,1,525,525,Ministerio de la Presidencia
Denise Canavaggio,0,1950,1,1950,1950,MINSA
Denise Delvalle,0,1785,3,1785,595,Ministerio del Ambiente
Deseriee Samaniego,600,1750,1,2350,2350,Ministerio del Ambiente
Desiderio León,0,900,1,900,900,MICI
Desiree Vergara,0,0,1,0,0,Ministerio del Ambiente
Diana Miranda,0,400,1,400,400,MINSA
Diana Salazar,28749,22800,10,51549,5155,MICI
Diana Toala,2921,4200,1,7121,7121,MICI
Didiel González,0,815,2,815,408,Ministerio del Ambiente
Diego Morales,0,720,1,720,720,AIG
Diego Mosquera,0,2700,1,2700,2700,Ministerio del Ambiente
Dilka Escobar,4875,13070,8,17945,2243,MEF
Dilsa Cedeño,0,0,2,0,0,MINSA
Dimas Nieto,0,2400,1,2400,2400,Ministerio de Seguridad Pública
Dinora Viquez,0,0,1,0,0,Ministerio del Ambiente
Dinorah Santamaría,1634,810,1,2444,2444,Ministerio del Ambiente
Diomedes Gonzalez,2497,4900,3,7397,2466,Ministerio de la Presidencia
Diomedes Vergara,0,1950,1,1950,1950,MINSA
Dionys Sanchez,0,5850,2,5850,2925,AIG
Diunayquis Lara,883,2500,1,3383,3383,MICI
Diwigdi Valiente,770,2400,1,3170,3170,MEF
Doralis Baso,1217,4200,1,5417,5417,MEF
Doris Diaz,0,2400,1,2400,2400,Ministerio de Seguridad Pública
Duc Mora,1094,1600,1,2694,2694,Ministerio de la Presidencia
Dulcidio De La Guardia,34717,33260,19,67977,3578,MEF
Eddy Arcia,0,1545,4,1545,386,Ministerio del Ambiente
Eder Cedeño,0,2400,1,2400,2400,Ministerio del Ambiente
Edgar Agames,1366,1200,2,2566,1283,MINSA
Edgar Arias,0,500,1,500,500,MICI
Edgar Chacón,0,525,1,525,525,Ministerio del Ambiente
Edgar D'angelo,2925,20380,6,23305,3884,MITRADEL
Edgar Dominguez,0,2345,3,2345,782,MINSA
Edgar Morales,0,2700,2,2700,1350,Ministerio del Ambiente
Edgar Murillo,0,2565,2,2565,1283,Ministerio del Ambiente
Edgar Ovalle,542,0,1,542,542,Ministerio de la Presidencia
Edgar Rodriguez,0,525,2,525,263,AIG
Edgar Tejada,1238,375,2,1613,806,AIG
Edgardo Hurtado,0,4500,1,4500,4500,Ministerio de Seguridad Pública
Edgardo Jaén,0,525,1,525,525,MIVIOT
Edgardo Ortega,0,1400,1,1400,1400,Ministerio del Ambiente
Edgardo Villalobos,1295,5670,3,6965,2322,MINSA
Edilberto Rivera,1217,4200,1,5417,5417,MEF
Edith Cajar,0,200,1,200,200,MICI
Ednadelis Flores,0,3675,6,3675,613,Ministerio del Ambiente
Edson Da Luz,1168,0,1,1168,1168,MEF
Eduardo Batista,2606,3300,3,5906,1969,Ministerio de la Presidencia
Eduardo Briceño,2969,7405,4,10374,2594,AIG
Eduardo Castillo,0,2600,2,2600,1300,MINSA
Eduardo Jaen,0,5150,2,5150,2575,AIG
Eduardo Navalo,0,540,1,540,540,MINSA
Eduardo Palacios,1009,1600,1,2609,2609,MICI
Eduardo Quirós,0,2520,1,2520,2520,MEF
Eduardo Villar,0,3450,1,3450,3450,Ministerio del Ambiente
Edwin Castellanos,1179,0,1,1179,1179,Ministerio de la Presidencia
Efraín Garrido,1917,4380,4,6297,1574,MEF
Efrain Villalobos,0,2000,1,2000,2000,Ministerio de Seguridad Pública
Eira Caballero,0,915,4,915,229,MINSA
Ela Jaén,1770,3600,1,5370,5370,MICI
Elba Cortés,0,2915,7,2915,416,Ministerio del Ambiente
Elbis Flores,1031,1500,1,2531,2531,AIG
Elda Velarde,0,1120,3,1120,373,MINSA
Elia Aviles,0,525,2,525,263,Ministerio del Ambiente
Elia Guerra,0,16170,13,16170,1244,Ministerio del Ambiente
Elio Rivera,7662,8725,5,16387,3277,Ministerio de la Presidencia
Elisa Castillo,0,315,1,315,315,MEF
Elisa Suarez,0,4800,1,4800,4800,MITRADEL
Elizabeth Clarke,0,6750,6,6750,1125,Ministerio del Ambiente
Elizabeth Gonzalez,4320,5150,2,9470,4735,Ministerio de la Presidencia
Elka Peralta,1177,2700,1,3877,3877,MEF
Eloisa Dutari,1398,2000,1,3398,3398,MEF
Eloy Espinosa,1360,0,1,1360,1360,Ministerio de la Presidencia
Eloy Fisher,2040,3060,2,5100,2550,MEF
Elsa Arenas,1148,4705,4,5853,1463,MINSA
Elsa Jara,1491,6600,1,8091,8091,MINSA
Elvia Flores,0,6800,2,6800,3400,MITRADEL
Elvia González,2302,4500,2,6802,3401,MEF
Emet Herrera,900,1440,2,2340,1170,Ministerio del Ambiente
Emilio Espino,5082,13300,7,18382,2626,MEF
Emilio Saavedra,0,600,1,600,600,MICI
Emilio Sempris,0,48695,19,48695,2563,Ministerio del Ambiente
Enielka Petrocelli,926,2700,1,3626,3626,MEF
Enrique Villavicencio,0,2400,1,2400,2400,Ministerio de Seguridad Pública
Erasmo Cedeño,3405,3215,3,6620,2207,MEF
Eric Carrion,0,1600,1,1600,1600,Ministerio de Seguridad Pública
Eric Conte,0,0,1,0,0,MINSA
Eric Espino,1031,1500,1,2531,2531,AIG
Eric Lopez,0,4800,2,4800,2400,Ministerio de Seguridad Pública
Eric Núñez,0,2700,2,2700,1350,Ministerio del Ambiente
Eric Ríos,4844,16950,7,21794,3113,MEF
Eric Rodríguez,0,12540,15,12540,836,Ministerio del Ambiente
Eric Ulloa,463,4900,8,5363,670,MINSA
Erick Barrios,6957,6350,4,13307,3327,Ministerio de la Presidencia
Erick Grajales,0,6800,2,6800,3400,MITRADEL
Erick Ortega,1257,2700,1,3957,3957,MEF
Ericka De Villatoro,940,0,1,940,940,Ministerio de la Presidencia
Ericka Gonzalez,0,3150,3,3150,1050,Ministerio de la Presidencia
Erika De León,0,630,1,630,630,Ministerio del Ambiente
Erika Saldaña,0,0,1,0,0,MOP
Erlyn Santana,3256,7100,5,10356,2071,MEF
Ermila Osorio,0,1230,5,1230,246,MINSA
Ernesto Lobo,735,0,1,735,735,Ministerio de la Presidencia
Ernesto Tristan,0,2250,1,2250,2250,Ministerio de la Presidencia
Erwin Romero,0,700,1,700,700,Ministerio del Ambiente
Esilda De Medina,0,1890,1,1890,1890,MEF
Esperanza Gonzalez,0,2400,1,2400,2400,Ministerio de Seguridad Pública
Esquivel Ramírez,0,11000,2,11000,5500,Ministerio del Ambiente
Essie Mastellari,1594,5600,2,7194,3597,MICI
Esteban Ortiz,0,200,1,200,200,MINSA
Esteban Pérez,0,630,1,630,630,Ministerio del Ambiente
Estela De La Guardia,0,0,2,0,0,MOP
Etmara Donoso,0,1400,1,1400,1400,Ministerio del Ambiente
Etzel Pallares,648,1350,1,1998,1998,MEF
Euclides Deago,222,1200,1,1422,1422,Ministerio de la Presidencia
Eufracio Centella,1500,900,1,2400,2400,MIDES
Euribiades Cano,1144,1890,2,3034,1517,MEF
Eusebia Calderon,0,300,1,300,300,MINSA
Eustorgio Jaén,0,1455,3,1455,485,Ministerio del Ambiente
Eva Muñoz,1144,2250,1,3394,3394,MEF
Eva Valdés,0,3150,1,3150,3150,Ministerio del Ambiente
Evelin Rodríguez,0,0,1,0,0,MEF
Evelyn Cooban,3087,7200,2,10287,5143,MEF
Evelyn Escobar,0,1755,1,1755,1755,MEF
Evelyn Garcia,0,735,1,735,735,Ministerio del Ambiente
Evelyn Montero,0,3600,1,3600,3600,Ministerio del Ambiente
Eyda Varela,45659,33150,14,78809,5629,MEF
Eysel Castillo,0,630,1,630,630,Ministerio del Ambiente
Ezequiel Meneses,0,600,1,600,600,MINSA
Fabián Baeza,3065,11350,3,14415,4805,MEF
Fabio Bedoya,0,1890,5,1890,378,MEF
Fabricio Pinzón,0,525,1,525,525,MITRADEL
Fania Roach,0,1900,4,1900,475,MINSA
Fanny Castañeda,0,600,1,600,600,MINSA
Fanny Castillo,0,0,1,0,0,MINSA
Fátima Díaz,0,6800,2,6800,3400,MITRADEL
Federico Armien,0,300,1,300,300,MINSA
Felicia Tullosh,0,200,1,200,200,MINSA
Felicia Tuloch,697,2375,2,3072,1536,MINSA
Feliciano Escobar,0,540,1,540,540,Ministerio del Ambiente
Felipe Contreras,2706,13920,2,16626,8313,MITRADEL
Félix Bonilla,0,0,2,0,0,MINSA
Felix Correa,0,300,1,300,300,MINSA
Felix Gonzalez,42599,800,2,43399,21700,Ministerio de la Presidencia
Felix Guerra,1321,700,1,2021,2021,Ministerio de la Presidencia
Félix Magallón,0,10320,4,10320,2580,Ministerio del Ambiente
Felix Stanziola,0,8490,5,8490,1698,MINSA
Félix Wing,0,8845,14,8845,632,Ministerio del Ambiente
Fernando De León,3795,4800,1,8595,8595,MEF
Fernando Diaz,1710,5815,11,7525,684,Ministerio de la Presidencia
Fernando Domínguez,0,3465,2,3465,1733,Ministerio del Ambiente
Fernando García,1366,3600,3,4966,1655,MITRADEL
Fernando Velasquez,1433,2100,1,3533,3533,Ministerio de la Presidencia
Fernando Vizcaino,0,630,1,630,630,MINSA
Fidel Alvarado,0,1050,1,1050,1050,MINSA
Fidel Quintero,0,2400,1,2400,2400,Ministerio de Seguridad Pública
Fidencio Ortega,0,1100,1,1100,1100,Ministerio del Ambiente
Flor Escudero,1217,5640,2,6857,3429,MEF
Flor Vanegas,1283,0,1,1283,1283,Ministerio de la Presidencia
Florencio Ayarza,0,2700,1,2700,2700,Ministerio del Ambiente
Francisco Barría,0,5635,2,5635,2818,Ministerio del Ambiente
Francisco Bustamante,4208,10800,5,15008,3002,MEF
Francisco Chavez,0,1050,1,1050,1050,MINSA
Francisco De Arco,0,2450,1,2450,2450,Ministerio del Ambiente
Francisco González,0,1350,1,1350,1350,MEF
Francisco Hirezi,661,0,1,661,661,Ministerio de la Presidencia
Francisco Montenegro,0,525,1,525,525,Ministerio del Ambiente
Francisco Ortiz,0,6800,2,6800,3400,MITRADEL
Francisco Sierra,3248,100,1,3348,3348,Ministerio de la Presidencia
Francisco Taylor,0,2700,2,2700,1350,Ministerio del Ambiente
Francisco Terrientes,7481,10110,9,17591,1955,MINSA
Francisco Trejos,0,0,1,0,0,MITRADEL
Franklin Garrido,0,1050,2,1050,525,MINSA
Franklin Sotillo,0,1890,1,1890,1890,MEF
Fredy Delagdo,0,10725,2,10725,5363,Ministerio del Ambiente
Fredys Peña,5668,10125,4,15793,3948,Ministerio de la Presidencia
Freshny Rodriguez,635,8550,6,9185,1531,MINSA
Frida Medrano,770,2400,1,3170,3170,MEF
Gabriel Castillo,0,9600,1,9600,9600,MITRADEL
Gabriel Ibarra,595,0,1,595,595,Ministerio de la Presidencia
Gabriel Reyes,0,540,1,540,540,AIG
Galo Macias,0,210,1,210,210,MINSA
Gaspar Da Costa,0,690,2,690,345,MINSA
Gehovelle Grau,0,420,1,420,420,Ministerio del Ambiente
Generoso Guerra,800,5220,4,6020,1505,Ministerio del Ambiente
Genevieve Epailly,0,2140,4,2140,535,MINSA
Genoveva Quintero,0,3100,4,3100,775,Ministerio del Ambiente
Georgina Osorio,1114,3615,7,4729,676,MEF
Gerardo González,2650,11295,8,13945,1743,Ministerio del Ambiente
Gerardo Guerrel,0,7815,4,7815,1954,MITRADEL
Geremías Aguilar,7500,20870,10,28370,2837,Ministerio del Ambiente
Germania Lara,0,1050,2,1050,525,Ministerio del Ambiente
Gilberto Subera,0,5400,2,5400,2700,Ministerio de Seguridad Pública
Gina Alvarado,1391,4200,1,5591,5591,MEF
Gioconda Castillero,0,500,1,500,500,MINSA
Giovanni Ceballos,589,1200,1,1789,1789,Ministerio de la Presidencia
Giselda Jaén,491,1050,1,1541,1541,MEF
Giselle García,1273,1050,1,2323,2323,MEF
Gisselle Domínguez,0,750,1,750,750,MICI
Gladys Tejada,0,675,1,675,675,MINSA
Gladys Villarreal,4500,1120,3,5620,1873,Ministerio del Ambiente
Glenón Álvarez,0,1470,2,1470,735,Ministerio del Ambiente
Glizmarluck Checa,528,1700,3,2228,743,MINSA
Gonzalo Prosper,13749,36875,11,50624,4602,Ministerio de la Presidencia
Graciela González,0,400,1,400,400,Ministerio del Ambiente
Grimaldo Córdoba,0,0,1,0,0,MINSA
Griselada Jimenez,225,1400,1,1625,1625,Ministerio de la Presidencia
Guadalupe Gracia,0,540,1,540,540,Ministerio del Ambiente
Guelfi Jean,0,0,3,0,0,MOP
Guillermina Macleary,0,1020,2,1020,510,MINSA
Guillermino Santamaria,0,700,1,700,700,MINSA
Guillermo Nicholson,0,1480,2,1480,740,Ministerio del Ambiente
Gustavo Valderrama,4996,9325,7,14321,2046,MEF
Hairo Correa,0,1050,1,1050,1050,MINSA
Harry Gonzalez,0,500,1,500,500,Ministerio de la Presidencia
Haydee De Lay,1753,5155,5,6908,1382,Ministerio de la Presidencia
Haydee Medina,0,4200,2,4200,2100,Ministerio del Ambiente
Hector Cedeño,0,420,1,420,420,MINSA
Héctor Rodríguez,0,7230,5,7230,1446,Ministerio de la Presidencia
Hector Ruiloba,5470,6500,6,11970,1995,Ministerio de la Presidencia
Hefer Morataya,661,0,1,661,661,Ministerio de la Presidencia
Hellington Ríos,0,0,1,0,0,Ministerio del Ambiente
Helmut Flores,1230,6800,4,8030,2008,Ministerio de la Presidencia
Helvecia Bonilla,0,4200,12,4200,350,Ministerio del Ambiente
Henry Gonzalez,0,315,1,315,315,Ministerio de la Presidencia
Hermel López,0,5745,2,5745,2873,Ministerio del Ambiente
Hermelinda Rodriguez,0,315,1,315,315,MINSA
Hermes Ortega,1300,1365,2,2665,1333,MIDES
Hernández Bonilla,0,4455,1,4455,4455,Ministerio del Ambiente
Hernando Rivera,0,400,1,400,400,MITRADEL
Hernando Rodríguez,836,7155,5,7991,1598,MITRADEL
Hilaria López,0,200,1,200,200,Ministerio del Ambiente
Hilario Sanchez,0,0,1,0,0,Ministerio del Ambiente
Homero Sealy,1694,3750,2,5444,2722,MEF
Horacio Estribi,1923,5700,3,7623,2541,MEF
Humberto Olarte,0,3515,4,3515,879,MINSA
Ibelice Añino,6389,22595,8,28984,3623,Ministerio del Ambiente
Ibero Fernández,0,675,1,675,675,MEF
Idalmis Aguilar,0,705,2,705,353,MINSA
Igor Alvarado,890,1980,2,2870,1435,MEF
Igor Saavedra,1307,2800,3,4107,1369,Ministerio de la Presidencia
Ileana Brea,2789,5430,4,8219,2055,MINSA
Ileen Lezcano,0,300,1,300,300,Ministerio de Seguridad Pública
Ilka Guerra,0,300,1,300,300,MINSA
Ilse Santos,0,615,2,615,308,MINSA
Ilse Zapata,0,8400,1,8400,8400,MINSA
Indira Credidio,0,420,1,420,420,MINSA
Indira Montezuma,0,0,1,0,0,Ministerio del Ambiente
Indira Palacio,0,3500,1,3500,3500,Ministerio de Seguridad Pública
Ingrid Gonzalez,0,1900,2,1900,950,MINSA
Ingrid Hernández,2208,6750,3,8958,2986,MEF
Iraida Graell,1474,2520,1,3994,3994,MITRADEL
Irene Abrego,5031,4675,5,9706,1941,Ministerio de la Presidencia
Irene Brostella,5101,4200,2,9301,4651,MOP
Iris Abrego,0,400,1,400,400,MINSA
Iris Hernández,591,630,1,1221,1221,MEF
Iris Monserrate,0,315,2,315,158,MINSA
Iris Vargas,0,630,1,630,630,Ministerio del Ambiente
Iritzel Santamaria,1962,6575,6,8537,1423,MINSA
Irvin Halman,7604,19645,13,27249,2096,AIG
Irving Villarreal,1398,2100,2,3498,1749,MOP
Isaac Castillo,1269,5040,7,6309,901,Ministerio de la Presidencia
Isabel Fernández,7107,16860,8,23967,2996,MEF
Isabel Lloyd,0,700,2,700,350,MINSA
Isabel Ortega,926,2700,1,3626,3626,MEF
Isidro Murillo,7478,10475,6,17953,2992,Ministerio de la Presidencia
Isis Carmen,0,525,1,525,525,Ministerio del Ambiente
Isis Góndola,0,300,1,300,300,Ministerio del Ambiente
Ismenia Castillero,0,1300,1,1300,1300,MINSA
Israel Cedeño,0,4120,7,4120,589,MINSA
Israel Tejada,3500,24925,11,28425,2584,Ministerio del Ambiente
Israel Torres,2000,22755,16,24755,1547,Ministerio del Ambiente
Itza Barahona,3724,16805,8,20529,2566,MINSA
Itza Mosca,1365,4700,2,6065,3033,MINSA
Itzel Rangel,400,8100,4,8500,2125,Ministerio del Ambiente
Itzel Salcedo,0,400,1,400,400,MITRADEL
Itzel Slocum,0,1210,2,1210,605,MINSA
Itzel Solis,0,1525,3,1525,508,MINSA
Itzel Vejas,0,2400,1,2400,2400,Ministerio del Ambiente
Itzi Atencio,0,11250,2,11250,5625,Ministerio de la Presidencia
Iván Jiménez,2465,4200,1,6665,6665,MICI
Iván Zarak,22872,16925,15,39797,2653,MEF
Ivania Balladares,972,0,1,972,972,Ministerio de la Presidencia
Ivelín Herrera,7868,8400,6,16268,2711,MICI
Ivellise Bonilla,1232,4200,1,5432,5432,MEF
Ivette Macías,673,2450,1,3123,3123,MEF
Ivonne Navarro,0,1750,2,1750,875,MINSA
Ixchel Carrasquilla,2225,9000,4,11225,2806,MINSA
Jacinto Navarro,1343,4200,1,5543,5543,MICI
Jackyn Herrera,0,315,1,315,315,Ministerio del Ambiente
Jacqueline Espinosa,994,2450,1,3444,3444,MEF
Jaime Abadia,0,0,1,0,0,MOP
Jaime Angell,0,1200,1,1200,1200,Ministerio de Seguridad Pública
Jaime Dominguez,0,630,1,630,630,MINSA
Jaime Paolo,897,2965,3,3862,1287,MINSA
Jaime Pimentel,0,525,1,525,525,Ministerio del Ambiente
Jaime Sanchez,2600,1605,3,4205,1402,Ministerio del Ambiente
Jaime Velez,0,2135,4,2135,534,MINSA
Jairo Valdés,1265,1600,1,2865,2865,MICI
Jannice Cigarruista,0,1500,1,1500,1500,MICI
Javier Alvarado,1467,0,1,1467,1467,Ministerio de la Presidencia
Javier Collado,0,540,1,540,540,MEF
Javier De León,2004,1000,2,3004,1502,Ministerio de la Presidencia
Javier Díaz,0,0,2,0,0,MINSA
Javier Galiali,0,0,1,0,0,MEF
Javier Lopez,0,100,1,100,100,MINSA
Javier Morales,0,4950,3,4950,1650,Ministerio del Ambiente
Javier Rodríguez,1290,4200,1,5490,5490,MEF
Javier Vasquez,3548,10700,5,14248,2850,Ministerio de la Presidencia
Jazmin Higuera,0,915,2,915,458,MINSA
Jean Aguilar,928,4200,1,5128,5128,MICI
Jean Digeon,3047,7800,2,10847,5424,MICI
Jecenia Sosa,1391,4200,1,5591,5591,MEF
Jenny De Chew,4153,6250,4,10403,2601,Ministerio de la Presidencia
Jenny Vergara,0,9900,6,9900,1650,MINSA
Jeracy Cogley,11193,18875,6,30068,5011,Ministerio de la Presidencia
Jesica Candanedo,0,420,1,420,420,MINSA
Jessica Sicilia,673,2450,1,3123,3123,MEF
Jesús Salazar,0,4800,1,4800,4800,Ministerio del Ambiente
Jilma Quiel,3500,3600,1,7100,7100,Ministerio del Ambiente
Joana Abrego,0,2310,3,2310,770,Ministerio del Ambiente
Jocelyn Mosaquites,0,5750,5,5750,1150,Ministerio del Ambiente
Joel Becker,0,0,1,0,0,Ministerio del Ambiente
Joel Díaz,0,525,1,525,525,MEF
Joel Him,0,750,1,750,750,Ministerio de la Presidencia
Joel Hurtado,6950,12150,4,19100,4775,Ministerio de la Presidencia
Joelbin De La Cruz,0,1050,2,1050,525,Ministerio del Ambiente
Jonathan Del Rosario,37009,27825,16,64834,4052,Ministerio de Seguridad Pública
Jonathan Díaz,1041,2000,1,3041,3041,MICI
Jonathan Núñez,0,12120,2,12120,6060,Ministerio del Ambiente
Jonathan Serrano,484,1200,1,1684,1684,Ministerio de la Presidencia
Jorge Andreve,0,11980,4,11980,2995,Ministerio del Ambiente
Jorge Bonilla,0,400,1,400,400,Ministerio del Ambiente
Jorge Dawson,0,315,2,315,158,MEF
Jorge Dominguez,0,200,1,200,200,Ministerio del Ambiente
Jorge Escudero,0,420,1,420,420,MEF
Jorge García,0,2820,2,2820,1410,Ministerio del Ambiente
Jorge Iglesias,1217,4200,1,5417,5417,MEF
Jorge Jaén,0,1630,3,1630,543,Ministerio del Ambiente
Jorge Justavino,0,7590,6,7590,1265,Ministerio del Ambiente
Jorge Lezcano,2587,8600,3,11187,3729,Ministerio de la Presidencia
Jorge Perez,878,2100,1,2978,2978,MINSA
Jorge Portugal Gutierrez,0,800,1,800,800,Ministerio de Seguridad Pública
Jorge Ramos,0,1080,2,1080,540,MEF
Jorge Rodriguez,762,1200,1,1962,1962,MINSA
Jorge Ruiz,0,600,1,600,600,MINSA
Jorge Silot,4503,9300,4,13803,3451,Ministerio de la Presidencia
Jorge Suarez,928,4200,1,5128,5128,MICI
Jorge Velasquez,1377,5500,2,6877,3439,Ministerio de la Presidencia
José Araúz,0,4450,4,4450,1113,Ministerio del Ambiente
José Batista,1257,2700,1,3957,3957,MEF
José Bethancourt,0,630,1,630,630,Ministerio del Ambiente
Jose Cadogan,635,4450,2,5085,2542,Ministerio de la Presidencia
José Carranza,0,0,1,0,0,MEF
José Carrión,0,315,1,315,315,Ministerio del Ambiente
José Castillo,0,630,1,630,630,Ministerio del Ambiente
José Cerrud,0,500,1,500,500,Ministerio del Ambiente
José Fernández,0,1935,2,1935,968,MEF
José Flores,0,1620,1,1620,1620,MEF
Jose Gomez,0,2400,1,2400,2400,Ministerio de Seguridad Pública
José González,0,675,1,675,675,Ministerio del Ambiente
Jose Lasso,0,4320,3,4320,1440,MINSA
José Pérez,0,0,1,0,0,Ministerio del Ambiente
José Quiros,0,2520,1,2520,2520,MEF
Jose Sanchez,843,1010,2,1853,927,Ministerio del Ambiente
José Santamaría,0,600,1,600,600,Ministerio del Ambiente
José Serracín,3065,11350,3,14415,4805,MEF
Joseu Alvarez,4428,5400,1,9828,9828,Ministerio de la Presidencia
Joseu Garcia,1094,2700,1,3794,3794,Ministerio de la Presidencia
Josip De Lora,0,2275,6,2275,379,MINSA
Josthyn Flores,0,6800,2,6800,3400,MITRADEL
Josue Garcia,9126,11700,3,20826,6942,Ministerio de la Presidencia
Josué Rivera,0,0,1,0,0,MITRADEL
Josue Rodriguez,1972,2100,1,4072,4072,Ministerio de la Presidencia
Josue Soto,706,2475,1,3181,3181,Ministerio de la Presidencia
Jovanys Gamboa,0,4800,2,4800,2400,Ministerio de Seguridad Pública
Jovel Nuñez,0,420,1,420,420,Ministerio del Ambiente
Juan Abrego,0,630,1,630,630,Ministerio del Ambiente
Juan Acosta,0,600,1,600,600,Ministerio de la Presidencia
Juan Castillo,4428,5400,1,9828,9828,Ministerio de la Presidencia
Juan Chavarria,0,1600,1,1600,1600,Ministerio de Seguridad Pública
Juan De Iglesias,2487,4800,1,7287,7287,Ministerio de la Presidencia
Juan Dios,0,630,1,630,630,Ministerio del Ambiente
Juan Gomez,0,735,2,735,368,MINSA
Juan Jaén,0,735,2,735,368,Ministerio del Ambiente
Juan Ledezma,0,9600,1,9600,9600,MITRADEL
Juan Lucero,1195,6100,2,7295,3648,Ministerio de la Presidencia
Juan Manuel González,0,525,1,525,525,MIVIOT
Juan Manuel Vásquez,0,480,1,480,480,MIVIOT
Juan Mártinez,1667,2520,1,4187,4187,MITRADEL
Juan Merida,0,3000,1,3000,3000,Ministerio de Seguridad Pública
Juan Monterrey,0,16335,9,16335,1815,Ministerio del Ambiente
Juan Pérez,0,1680,2,1680,840,Ministerio del Ambiente
Juan Pinto,0,735,1,735,735,Ministerio del Ambiente
Juan Sánchez,0,2520,1,2520,2520,MEF
Juan Varela,9552,0,2,9552,4776,Ministerio de la Presidencia
Juana Montero,1391,4200,1,5591,5591,MEF
Judit Amaya,0,300,1,300,300,Ministerio del Ambiente
Judit Jaén,0,3105,3,3105,1035,Ministerio del Ambiente
Judith Aparicio,443,1800,2,2243,1122,MITRADEL
Judith Jimenez,3635,5200,3,8835,2945,MICI
Julieta Fernández,0,1050,3,1050,350,Ministerio del Ambiente
Julio Aguirre,7680,9150,4,16830,4208,MEF
Julio Castillo,0,3650,5,3650,730,MINSA
Julio Coronado,0,3810,2,3810,1905,MITRADEL
Julio Escarriola,1112,4950,2,6062,3031,MEF
Julio Miranda,0,0,1,0,0,MEF
Julio Palacio,0,1260,1,1260,1260,Ministerio de la Presidencia
Julio Polanco,0,0,1,0,0,MITRADEL
Julio Santamaria,357,2620,3,2977,992,MINSA
Julio Urriola,0,375,1,375,375,Ministerio de Seguridad Pública
Julisa Caballero,0,1050,1,1050,1050,MINSA
Julissa Abrego,1391,4200,1,5591,5591,MEF
Julissa Estrada,5588,15300,8,20888,2611,MICI
Justina Suman,0,540,1,540,540,MINSA
Justo Arrocha,0,600,1,600,600,MINSA
Kadim Medina,0,405,1,405,405,MINSA
Karelis Castrejon,2159,5400,1,7559,7559,Ministerio de la Presidencia
Karen López,0,2385,3,2385,795,MEF
Karen Ortega,0,855,2,855,428,AIG
Karima Lince,0,1605,2,1605,803,Ministerio del Ambiente
Karima Torres,0,0,1,0,0,MINSA
Karina Mirones,0,0,1,0,0,MINSA
Karina Ortiz,700,3150,2,3850,1925,Ministerio del Ambiente
Karina Rivera,0,540,1,540,540,Ministerio del Ambiente
Karla Carvajal,763,3000,1,3763,3763,MICI
Karolyn Chong,0,1125,1,1125,1125,MINSA
Katherine Achong,0,1260,1,1260,1260,MEF
Katherine Rivera,0,3150,1,3150,3150,Ministerio del Ambiente
Kathia Mojica,0,1680,4,1680,420,Ministerio del Ambiente
Katife Kose,0,2400,1,2400,2400,MITRADEL
Kattya Guerra,0,660,1,660,660,MIDES
Kattya Juliao,0,3570,3,3570,1190,MIDES
Katyuska Correa,7617,9350,5,16967,3393,MEF
Keith Jimenez,4596,12050,5,16646,3329,Ministerio de la Presidencia
Kenia Alonso,0,2550,1,2550,2550,MITRADEL
Kenia Lezcano,1645,2400,2,4045,2023,Ministerio de la Presidencia
Kenia Porcell,0,1800,1,1800,1800,Ministerio de Seguridad Pública
Keren Batista,0,400,1,400,400,MICI
Kharen Rodriguez,0,0,1,0,0,MOP
Kiara Diaz,0,400,1,400,400,MINSA
Krissel Sandoval,0,500,1,500,500,Ministerio del Ambiente
Krizia Matthews,1864,5400,1,7264,7264,MICI
Lady Palacios,0,420,1,420,420,Ministerio del Ambiente
Laiza Johnson,0,735,1,735,735,MIDES
Laura Godoy,1179,0,1,1179,1179,Ministerio de la Presidencia
Laura Pérez,582,540,1,1122,1122,MEF
Laura Solis,0,400,1,400,400,MINSA
Ledys Díaz,479,1200,1,1679,1679,MITRADEL
Lelys Rodríguez,0,3510,1,3510,3510,Ministerio del Ambiente
Lenisel Saavedra,1328,4900,3,6228,2076,Ministerio del Ambiente
Leonardo Uribe,816,6250,3,7066,2355,MICI
Leoncio Pardo,0,2400,1,2400,2400,Ministerio de Seguridad Pública
Leonel Linares,1869,2250,1,4119,4119,MEF
Leopoldo Quinzada,0,6800,2,6800,3400,MITRADEL
Leovigildo Vargas,0,300,1,300,300,Ministerio del Ambiente
Lesbia Aldeano,1371,2000,1,3371,3371,Ministerio de la Presidencia
Lesbia Mojica,0,420,1,420,420,MINSA
Lesly Salmeron,5836,14850,6,20686,3448,Ministerio de la Presidencia
Leticia Samaniego,0,18075,4,18075,4519,Ministerio del Ambiente
Leyda Aparicio,1971,6600,2,8571,4285,MICI
Leydis Martínez,0,2415,1,2415,2415,MITRADEL
Liane Ortega,0,270,1,270,270,MIDES
Lideika Espinosa,2522,4550,3,7072,2357,Ministerio de la Presidencia
Lidia Acosta,665,1350,1,2015,2015,MEF
Ligia De Landau,2405,3650,2,6055,3028,Ministerio de la Presidencia
Lili-ann Núñez,1484,2100,1,3584,3584,MEF
Lilia Sanchez,0,720,1,720,720,MINSA
Liliana Santamaria,0,1050,1,1050,1050,MINSA
Liliana Vargas,0,3000,1,3000,3000,MINSA
Liliane Valdes,0,300,1,300,300,MINSA
Lilibeth Barba,0,1155,1,1155,1155,Ministerio del Ambiente
Lilibeth Castillo,0,2520,1,2520,2520,MEF
Linda Castillo,4035,8050,6,12085,2014,MICI
Linda Iglesias,1490,3850,7,5340,763,MOP
Linda Pérez,593,700,1,1293,1293,MEF
Lineth Arcia,0,11970,8,11970,1496,Ministerio del Ambiente
Lineth Serrano,841,1125,1,1966,1966,MEF
Lionel Quiróz,0,1400,3,1400,467,Ministerio del Ambiente
Lionso Solís,0,0,1,0,0,Ministerio del Ambiente
Lisa Kam,397,1600,1,1997,1997,MOP
Lisamarie Escudero,585,1800,1,2385,2385,MEF
Lisbeth Carreiro,628,1750,1,2378,2378,Ministerio del Ambiente
Lissete Chang,0,400,2,400,200,MINSA
Lisseth Rodriguez,0,0,1,0,0,Ministerio del Ambiente
Lissette Lopez,1433,2100,1,3533,3533,Ministerio de la Presidencia
Lissette Trejos,0,1600,3,1600,533,Ministerio del Ambiente
Lissette Wheattey,977,3600,1,4577,4577,MICI
Lissy Tapia,0,1260,3,1260,420,Ministerio del Ambiente
Liza Lay,0,3570,3,3570,1190,MINSA
Lizamor César,2200,7200,3,9400,3133,MICI
Lizbeth Alfonso,0,525,1,525,525,MIVIOT
Lizbeth Cerezo,0,1400,3,1400,467,MINSA
Lizi Rose,1022,2700,1,3722,3722,MEF
Lohanniz Gaitan,2668,5700,1,8368,8368,Ministerio de la Presidencia
Lorena Barroso,1391,4200,1,5591,5591,MEF
Lorena De Varela,20018,0,5,20018,4004,Ministerio de la Presidencia
Lorena Merlo,0,400,1,400,400,MINSA
Lorena Peña,704,0,1,704,704,Ministerio de la Presidencia
Lorena Pinzón,0,405,1,405,405,Ministerio del Ambiente
Lorena Rojas,0,500,1,500,500,MINSA
Lorena Vanegas,0,1170,2,1170,585,Ministerio del Ambiente
Lourdes Adames,0,3750,3,3750,1250,Ministerio del Ambiente
Lourdes Almengor,0,2250,1,2250,2250,Ministerio de la Presidencia
Lourdes Arjona,435,0,1,435,435,MEF
Lourdes Contreras,222,1200,1,1422,1422,Ministerio de la Presidencia
Lourdes Garcia,0,2915,5,2915,583,MINSA
Lourdes López,463,2250,3,2713,904,MINSA
Lourdes Moreno,0,1100,3,1100,367,MINSA
Lourdes Ubide,0,5400,2,5400,2700,Ministerio del Ambiente
Lourdes Villareal De Loré,0,1050,2,1050,525,MIVIOT
Lucas Cabarcos,0,0,1,0,0,MOP
Lucía Chandeck,0,0,2,0,0,Ministerio del Ambiente
Lucila Vernon,14232,23625,11,37857,3442,Ministerio de la Presidencia
Lucrecia Quintero,0,450,1,450,450,Ministerio del Ambiente
Luigi González,1609,4800,1,6409,6409,MICI
Luigi Rivas,0,2520,1,2520,2520,MEF
Luis Carles,6278,19250,8,25528,3191,MITRADEL
Luis Delgado,0,315,1,315,315,Ministerio del Ambiente
Luis Fasano,1849,3500,1,5349,5349,AIG
Luis Garrido,7788,17800,7,25588,3655,MICI
Luis Guerrero,0,500,1,500,500,MINSA
Luis Lamboglia,700,1400,1,2100,2100,Ministerio del Ambiente
Luis Lezcano,0,2800,1,2800,2800,Ministerio del Ambiente
Luis Llorente,1484,2100,1,3584,3584,MEF
Luis Ocando*,1216,350,1,1566,1566,MEF
Luis Palma,0,0,1,0,0,MINSA
Luis Pineda,0,400,1,400,400,MINSA
Luis Prestan,0,0,1,0,0,MOP
Luis Quiroz,0,2400,1,2400,2400,Ministerio de Seguridad Pública
Luis Rojer,6694,6700,4,13394,3349,MICI
Luis Santos,1391,4200,1,5591,5591,MEF
Luis Vega,2149,11450,7,13599,1943,Ministerio del Ambiente
Luz Lasso,1585,2550,2,4135,2068,MINSA
Lydia Clark,0,810,1,810,810,MEF
Ma. Gracia,0,0,1,0,0,Ministerio del Ambiente
Mabel Bernal,0,725,2,725,363,MINSA
Mabel Morcillo,0,1715,2,1715,858,Ministerio del Ambiente
Magaly Castillo,0,1965,5,1965,393,Ministerio del Ambiente
Magsanda Abrego,2057,6180,4,8237,2059,MITRADEL
Maite Montes,0,500,1,500,500,Ministerio de Seguridad Pública
Manuel Burgos,0,1500,2,1500,750,Ministerio de Seguridad Pública
Manuel Dominguez,29276,17700,6,46976,7829,Ministerio de la Presidencia
Manuel Lopez,716,1365,2,2081,1040,Ministerio del Ambiente
Manuel Ortega,0,925,2,925,463,Ministerio del Ambiente
Manuel Quintero,0,3060,1,3060,3060,AIG
Manuel Rodríguez,0,6800,2,6800,3400,MITRADEL
Manuel Sieiro,0,1400,1,1400,1400,MINSA
Manuel Soriano,1923,6275,4,8198,2049,Ministerio de la Presidencia
Manuel Von Chong,0,6300,1,6300,6300,Ministerio de la Presidencia
Marcela Boyd,790,750,1,1540,1540,Ministerio de la Presidencia
Marcia González,0,315,1,315,315,Ministerio del Ambiente
Marcia Rivera,0,6100,2,6100,3050,Ministerio de Seguridad Pública
Marcial Arias,0,600,1,600,600,Ministerio del Ambiente
Marcial Buitrago,0,210,1,210,210,MIDES
Marco Correa,926,2700,1,3626,3626,MEF
Marcos Ledezma,14365,19575,6,33940,5657,Ministerio de la Presidencia
Marcos Young,2297,2550,3,4847,1616,MINSA
Margarita Antadillas,2233,5600,2,7833,3916,MICI
Margarita Guerra,0,420,1,420,420,Ministerio del Ambiente
Marggina Aranda,0,940,2,940,470,MINSA
Maria Arosemena,2789,4800,1,7589,7589,MINSA
María Barrios,0,4515,7,4515,645,Ministerio del Ambiente
Maria De Crespo,0,415,1,415,415,MINSA
María De Las Mercedes,1400,630,1,2030,2030,MIDES
María De León,0,3570,2,3570,1785,MITRADEL
Maria Del Rosario,842,800,1,1642,1642,Ministerio de la Presidencia
Maria Diaz,3408,6600,1,10008,10008,Ministerio de la Presidencia
Maria Esquivel,0,10180,10,10180,1018,MINSA
María González,0,210,1,210,210,MEF
Maria Gracia,6399,7500,2,13899,6950,Ministerio de la Presidencia
María Gutiérrez,0,400,1,400,400,Ministerio del Ambiente
Maria Iriarte,0,420,1,420,420,MINSA
Maria Mastelari,0,800,2,800,400,MINSA
Maria Monzon,2614,7250,2,9864,4932,Ministerio de la Presidencia
María Murgas,1839,4320,1,6159,6159,MITRADEL
María Ordoñez,1427,8650,4,10077,2519,MITRADEL
Maria Peralta,2487,4800,1,7287,7287,Ministerio de la Presidencia
Maria Perez,0,500,1,500,500,MINSA
Maria Quidiello,982,0,1,982,982,Ministerio de la Presidencia
María Rodríguez,0,200,1,200,200,MEF
María Rojas,2300,3000,1,5300,5300,MEF
Maria Sanchez,982,0,1,982,982,Ministerio de la Presidencia
Maria Solis,0,1200,1,1200,1200,MINSA
María Suarez,1000,1050,1,2050,2050,MIDES
María Tapia,1869,2250,1,4119,4119,MEF
María Urriola,1917,4120,2,6037,3019,MITRADEL
María Vergara,1235,5000,2,6235,3118,MICI
María Villalaz,0,420,1,420,420,MEF
María Yolanda Álvarez,1507,2880,2,4387,2194,MIVIOT
Marialina Isaza,0,615,2,615,308,Ministerio de Seguridad Pública
Mariana Lopez,0,1350,1,1350,1350,MINSA
Marianela Broce,1083,1050,1,2133,2133,MEF
Marianela Palacios,0,525,2,525,263,MEF
Marianela Salazar,2397,3775,2,6172,3086,Ministerio de la Presidencia
Maribel E. Quintero R.,2098,2250,1,4348,4348,MIVIOT
Maricarmen Mendizabal,1417,5400,1,6817,6817,MEF
Maricela Delgado,3308,8680,3,11988,3996,MEF
Mariel Aizpurúa,0,2520,1,2520,2520,MEF
Mariel Nuñez,508,900,1,1408,1408,MEF
Mariel Sanjur,0,1980,1,1980,1980,Ministerio del Ambiente
Mariela Barrera,0,735,2,735,368,MINSA
Mariela Gonzalez,0,405,1,405,405,MINSA
Mariela Sánchez,0,900,1,900,900,MIDES
Mariela Vives,0,2200,2,2200,1100,Ministerio de Seguridad Pública
Mariela Zurita,1749,11475,6,13224,2204,MINSA
Marietta Jaen,9783,11000,3,20783,6928,MOP
Marina Gallardo,915,1980,2,2895,1448,Ministerio del Ambiente
Marina Rodriguez,2809,3135,2,5944,2972,Ministerio de la Presidencia
Marined Hurtado,0,2400,1,2400,2400,Ministerio de Seguridad Pública
Marino Abrego,0,1560,3,1560,520,MIDES
Mario Etchelecu,1689,500,1,2189,2189,MIVIOT
Mario Gongora,0,1530,2,1530,765,AIG
Mario Sánchez,0,9600,1,9600,9600,MITRADEL
Marío Santamaría,0,7000,2,7000,3500,Ministerio del Ambiente
Mario Torrero,653,4200,3,4853,1618,MINSA
Marisabel Oses,1,4550,1,4551,4551,MITRADEL
Marisol Dimas,0,11540,5,11540,2308,Ministerio del Ambiente
Marisol Guerra,0,2100,1,2100,2100,Ministerio de Seguridad Pública
marisol Sierra,654,900,1,1554,1554,MEF
Marissa Espino,1433,2100,1,3533,3533,Ministerio de la Presidencia
Marissa Pitti,0,630,1,630,630,Ministerio del Ambiente
Maritza Dean,0,2400,1,2400,2400,MITRADEL
Maritza Nieto,0,3700,7,3700,529,MINSA
Marixenia Álvarez,524,10125,2,10649,5325,MITRADEL
Marlenis Marin,0,1665,2,1665,833,Ministerio del Ambiente
Marleny Sánchez,0,420,1,420,420,MEF
Marling Villarreal,0,525,1,525,525,Ministerio del Ambiente
Marlon Herrera,3841,6700,3,10541,3514,MICI
Marta Batres,644,0,1,644,644,Ministerio de la Presidencia
Marta Bernal,1195,2410,2,3605,1803,Ministerio de la Presidencia
Marta Domingo,0,4590,3,4590,1530,Ministerio del Ambiente
Marta Lengua,1365,0,1,1365,1365,MINSA
Marta Moreno,0,525,1,525,525,Ministerio del Ambiente
Martha De González,0,2940,4,2940,735,MEF
Martin Alpirez,0,1050,1,1050,1050,MINSA
Martín Barciela,3590,6405,3,9995,3332,MEF
Martin Testa,0,7215,5,7215,1443,Ministerio del Ambiente
Martiniano Higüero,4440,6070,3,10510,3503,MITRADEL
Maruquel Pabón,1767,4550,2,6317,3159,MEF
Marury Pimentel,1819,5233,2,7052,3526,MITRADEL
Marvin Aparicio,0,2520,1,2520,2520,MEF
Marvin Rodríguez,1200,2250,1,3450,3450,MIDES
Maskil Solis,0,1300,1,1300,1300,MINSA
Massiel Vega,0,6600,1,6600,6600,Ministerio del Ambiente
Maura Aparicio,786,3080,2,3866,1933,MEF
Mauricio Bermuez,1031,0,1,1031,1031,Ministerio de la Presidencia
Mauricio Fuentes,0,900,1,900,900,Ministerio del Ambiente
Mauro Bairnarls,5414,17570,10,22984,2298,MEF
Max Cedeño,585,3200,2,3785,1892,MOP
Max Ramirez,0,420,1,420,420,MINSA
Mayka De Leon,0,2400,1,2400,2400,Ministerio de Seguridad Pública
Mayra Abood,1577,1200,1,2777,2777,MINSA
Mayra Botacio,0,2660,4,2660,665,MINSA
Medardo Rosas,0,600,1,600,600,MITRADEL
Melissa Sanjur,0,6800,2,6800,3400,MITRADEL
Melissa Vasquez,0,600,1,600,600,Ministerio de Seguridad Pública
Melissa Velarde,23779,9700,5,33479,6696,Ministerio de la Presidencia
Melitza De Leon,561,5400,2,5961,2980,Ministerio de la Presidencia
Melva Cruz,0,500,1,500,500,MINSA
Mercedes Ochoa,0,3100,2,3100,1550,Ministerio del Ambiente
Mercedes Perez,0,1215,2,1215,608,MIDES
Michelle Dominguez,1812,2500,2,4312,2156,Ministerio de la Presidencia
Michelle Gonzalez,10396,34650,8,45046,5631,Ministerio de la Presidencia
Michelle Mastellari,757,4050,2,4807,2404,MEF
Mickeal Trotman,0,1600,1,1600,1600,Ministerio de Seguridad Pública
Miguel Batista,0,420,1,420,420,Ministerio del Ambiente
Miguel Esbri,11580,24975,9,36555,4062,Ministerio de la Presidencia
Miguel Jaén,0,2520,1,2520,2520,MEF
Miguel Mayo,21937,27850,15,49787,3319,MINSA
Miguel Pandales,2053,2380,2,4433,2216,MEF
Miguel Rodríguez,0,3600,1,3600,3600,Ministerio del Ambiente
Miguel Santiago,0,3500,3,3500,1167,Ministerio del Ambiente
Miguel Yau,0,2000,1,2000,2000,AIG
Milagros Caicedo,0,600,1,600,600,MINSA
Milagros Díaz,0,375,1,375,375,Ministerio del Ambiente
Mileyka Chandeck,604,5640,2,6244,3122,MITRADEL
Mileyka Zambrano,753,2800,1,3553,3553,MEF
Mirei Endara,0,23280,13,23280,1791,Ministerio del Ambiente
Miriam Figueroa,0,9600,1,9600,9600,MITRADEL
Mirka Rodriguez,0,2050,2,2050,1025,MINSA
Mirna Chung,1172,1230,2,2402,1201,MEF
Mirta Benítez,0,2045,6,2045,341,Ministerio del Ambiente
Mirtha Frías,1200,1350,1,2550,2550,MIDES
Mitzela Villareal,0,630,1,630,630,MINSA
Mitzila Rosas,0,600,1,600,600,MINSA
Mixcel Villagra,0,7560,1,7560,7560,Ministerio del Ambiente
Modesto Pascacio,543,1750,1,2293,2293,MEF
Modesto Tuñon,0,3000,2,3000,1500,Ministerio del Ambiente
Mónica Atencio,1569,3600,1,5169,5169,MITRADEL
Monica Diaz,0,400,1,400,400,MINSA
Muhamed Hajee,12123,12350,6,24473,4079,Ministerio de la Presidencia
Myrna Mclaughlin,0,4350,3,4350,1450,MINSA
Nacor Trejos,0,315,1,315,315,Ministerio del Ambiente
Nadgris Correa,0,3000,1,3000,3000,Ministerio de la Presidencia
Nadja Benson,3406,10450,5,13856,2771,MINSA
Nadja Porcel,1545,2820,2,4365,2183,MINSA
Napoleon Torres,3292,4100,4,7392,1848,Ministerio de la Presidencia
Narciso Cubas,0,675,1,675,675,Ministerio del Ambiente
Narciso Gónzalez,0,300,1,300,300,Ministerio del Ambiente
Narciso Machuca,627,300,1,927,927,Ministerio de la Presidencia
Natasha Dormoi,3025,19725,12,22750,1896,MINSA
Natasha Risseeuw,0,10600,7,10600,1514,Ministerio del Ambiente
Natividad Jaramillo,0,0,2,0,0,Ministerio del Ambiente
Nayda Salas,1739,1625,2,3364,1682,Ministerio de la Presidencia
Nazareth Del Carmen,2120,1400,1,3520,3520,Ministerio de la Presidencia
Nekelda Nelson,6108,7875,4,13983,3496,Ministerio de la Presidencia
Nelida Ortiz,842,800,1,1642,1642,Ministerio de la Presidencia
Nelly Becerra,0,420,1,420,420,Ministerio del Ambiente
Nelly Koong,0,2400,1,2400,2400,Ministerio de Seguridad Pública
Nelsi Tejada,1200,2250,1,3450,3450,MIDES
Nelson Castillo,658,6650,5,7308,1462,Ministerio de la Presidencia
Nery Esquivel,0,0,1,0,0,Ministerio del Ambiente
Néstor González,15702,13200,6,28902,4817,MICI
Néstor Murillo,0,630,1,630,630,Ministerio del Ambiente
Neyra Herrera,0,6360,7,6360,909,Ministerio del Ambiente
Nicolasa Chavarría,706,1125,1,1831,1831,MEF
Nicole Fernández,1080,4200,1,5280,5280,MEF
Nicole O´callaghan,0,945,1,945,945,Ministerio del Ambiente
Nicomedes Jiménez,0,2800,2,2800,1400,Ministerio del Ambiente
Nidia Pino,0,525,1,525,525,MITRADEL
Niurka Gonzalez,1800,6400,7,8200,1171,MINSA
Nivardo Ibarra,0,6345,2,6345,3173,Ministerio del Ambiente
Noel Trejos,0,10795,6,10795,1799,Ministerio del Ambiente
Nohelia Medina,0,315,1,315,315,Ministerio del Ambiente
Nohely Nieto,0,6510,3,6510,2170,MITRADEL
Noriel Castillo,0,0,1,0,0,MINSA
Noriela Maure,0,315,1,315,315,Ministerio del Ambiente
Noris Toribio,0,1050,1,1050,1050,Ministerio del Ambiente
Noris Vásquez,0,0,1,0,0,MEF
Norma Astudillo,0,1320,2,1320,660,MINSA
Norman Harris,3031,13400,3,16431,5477,MICI
Nubia Del Carmen,0,0,1,0,0,MOP
Nurkia Arosemena,1585,2250,1,3835,3835,MINSA
Octavio De La Cruz,6138,12850,4,18988,4747,Ministerio de la Presidencia
Octavio Espinosa,658,1600,1,2258,2258,Ministerio de la Presidencia
Odalis Sinisterra,0,405,1,405,405,MINSA
Oderay Gonzalez,0,825,2,825,413,MINSA
Okir Ortega,1301,3825,2,5126,2563,Ministerio del Ambiente
Oliver Serrano,985,2535,7,3520,503,MEF
Olivia Zuñiga,1,0,1,1,1,Ministerio de la Presidencia
Olmedo Arrocha,0,525,1,525,525,MEF
Olmedo Pérez,0,5280,4,5280,1320,Ministerio del Ambiente
Omaira Mora,1120,2250,1,3370,3370,MEF
Omaira Tejada,0,300,1,300,300,MINSA
Omar Abrego,0,500,2,500,250,Ministerio del Ambiente
Omar Blandon,0,6800,2,6800,3400,Ministerio de Seguridad Pública
Omar Castillo,1209,1500,1,2709,2709,MICI
Omar Gómez,579,4375,7,4954,708,MEF
Omar González,1110,1120,2,2230,1115,MEF
Omar Justiniani,0,1200,1,1200,1200,Ministerio de la Presidencia
Omar Kai,0,4140,1,4140,4140,Ministerio del Ambiente
Omar Miranda,1217,4200,1,5417,5417,MEF
Orlando Bernal,1750,4735,4,6485,1621,Ministerio del Ambiente
Orley Jimenez,0,2800,2,2800,1400,Ministerio de Seguridad Pública
Oscar Calvillo,716,0,1,716,716,Ministerio de la Presidencia
Oscar Galvez,1170,2925,2,4095,2047,Ministerio de la Presidencia
Osyuldo Márquez,0,525,1,525,525,Ministerio del Ambiente
Otto Escartin,9765,16050,6,25815,4302,Ministerio de la Presidencia
Ovidio Fuentes,0,5200,2,5200,2600,Ministerio de Seguridad Pública
Pablo Cosio,0,600,1,600,600,MINSA
Pablo Guerra,0,1785,2,1785,893,Ministerio del Ambiente
Pablo Hamilton,0,2520,1,2520,2520,MEF
Pablo Morales,1589,0,1,1589,1589,AIG
Pablo Ruidiaz,6014,9080,6,15094,2516,AIG
Pacifico Chung,3274,2550,4,5824,1456,MOP
Padre Fontane,2736,0,1,2736,2736,Ministerio de la Presidencia
Paola Jaén,4900,6965,6,11865,1978,Ministerio del Ambiente
Patricia Batista,0,2400,1,2400,2400,Ministerio de Seguridad Pública
Patricia Castillo,1391,4200,1,5591,5591,MEF
Patricia De Saldaña,6487,10200,2,16687,8343,MEF
Patricia Lee,0,8400,3,8400,2800,Ministerio de Seguridad Pública
Patricia Quintana,2276,6425,4,8701,2175,MEF
Patricia Urriola,1274,700,1,1974,1974,MITRADEL
Paula Mese,0,3000,1,3000,3000,Ministerio de la Presidencia
Pebbles Muñoz,7031,21200,8,28231,3529,MICI
Pedro Escobar,897,1750,1,2647,2647,MIDES
Pedro Espinosa,514,1750,2,2264,1132,MEF
Pedro Sarasqueta,753,2800,1,3553,3553,MEF
Pedro Vivar,0,1340,2,1340,670,Ministerio del Ambiente
Pierre Fontane,0,6800,2,6800,3400,MITRADEL
Pilar Santiago,8864,28400,9,37264,4140,MICI
Piney Torres,0,0,1,0,0,Ministerio del Ambiente
Porfirio Molina,0,600,2,600,300,Ministerio del Ambiente
Porfirio Rangel,0,0,4,0,0,MOP
Publio Cortés,6335,12200,6,18535,3089,MEF
Quelso Muñoz,0,2400,1,2400,2400,Ministerio de Seguridad Pública
Radames Zambrano,0,525,1,525,525,MITRADEL
Rafael Chavarría,0,7800,2,7800,3900,MITRADEL
Rafael Perez,0,675,1,675,675,MINSA
Rafael Reyes,1183,2400,1,3583,3583,Ministerio de la Presidencia
Rafael Taveras,1281,0,1,1281,1281,Ministerio de la Presidencia
Raisa Alvarado,0,915,2,915,458,Ministerio del Ambiente
Ramon Arosemena,12681,14400,5,27081,5416,MOP
Ramon Balid,2999,6060,2,9059,4530,AIG
Ramon Castillo,0,1050,1,1050,1050,MINSA
Ramon Ramon,0,1050,1,1050,1050,MINSA
Raquel Martínez,0,750,1,750,750,MICI
Raquel Mock,0,720,1,720,720,MINSA
Raul Bravo,0,3325,6,3325,554,MINSA
Raúl Díaz,0,2800,1,2800,2800,Ministerio del Ambiente
Raúl González,0,420,1,420,420,Ministerio del Ambiente
Raúl Gutierrez,1125,4140,4,5265,1316,Ministerio del Ambiente
Raul Millan,0,540,1,540,540,AIG
Raúl Moreira,0,210,1,210,210,MEF
Raul Noriega,2474,1200,2,3674,1837,MINSA
Raúl Pinedo,5550,40365,18,45915,2551,Ministerio del Ambiente
Raul Sandoval,20925,5650,5,26575,5315,Ministerio de la Presidencia
Rebeca Ramirez,791,4500,4,5291,1323,Ministerio de la Presidencia
Reina Roa,1476,31845,15,33321,2221,MINSA
Remigio Almanza,0,2700,1,2700,2700,Ministerio del Ambiente
René López,0,2400,1,2400,2400,Ministerio del Ambiente
Rene Moses,0,9800,4,9800,2450,Ministerio de Seguridad Pública
Rene Ortega,0,4800,2,4800,2400,Ministerio de Seguridad Pública
Renza De Sánchez,397,1600,1,1997,1997,MOP
Reynaldo Nuñez,0,1600,1,1600,1600,Ministerio de la Presidencia
Ribana Molino,1366,800,1,2166,2166,MINSA
Ricardo Barranco,0,2030,2,2030,1015,Ministerio del Ambiente
Ricardo Chacon,1817,7950,3,9767,3256,Ministerio de Seguridad Pública
Ricardo Diaz,697,1500,1,2197,2197,Ministerio de Seguridad Pública
Ricardo Goti,840,7905,10,8745,875,MINSA
Ricardo Hughes,0,2150,3,2150,717,MINSA
Ricardo Melo,1635,2250,1,3885,3885,Ministerio de la Presidencia
Ricardo Mercado,0,1050,1,1050,1050,MINSA
Ricardo Quiel,2638,9200,3,11838,3946,MICI
Ricardo Raymore,0,1050,1,1050,1050,MINSA
Ricardo Rocha,5033,7500,4,12533,3133,MEF
Ricardo Saldaña,0,1050,1,1050,1050,MINSA
Ricardo Wong,0,4800,2,4800,2400,Ministerio de Seguridad Pública
Ricardo Ycaza,0,400,1,400,400,Ministerio del Ambiente
Ricardo Zubieta,4984,11650,7,16634,2376,MEF
Ricaurte Baloy,0,3600,2,3600,1800,Ministerio de Seguridad Pública
Rigoberto Lu,0,630,1,630,630,Ministerio del Ambiente
Rigoberto Samaniego,0,400,1,400,400,MINSA
Rigoberto Villareal,0,400,1,400,400,MINSA
Rita Orozco,3500,8385,7,11885,1698,Ministerio del Ambiente
Roberto Ballesteros,3500,4200,2,7700,3850,Ministerio del Ambiente
Roberto Bonilla,0,5310,7,5310,759,Ministerio del Ambiente
Roberto Castillo,0,3000,1,3000,3000,Ministerio de Seguridad Pública
Roberto Galan,1634,4800,7,6434,919,Ministerio del Ambiente
Roberto Guerrero,256,6600,4,6856,1714,Ministerio de Seguridad Pública
Roberto Hernández,3899,24000,3,27899,9300,MEF
Roberto Jiménez,0,6800,2,6800,3400,MITRADEL
Roberto Martinez,980,1800,1,2780,2780,MEF
Roberto Santoya,11833,13450,5,25283,5057,Ministerio de la Presidencia
Rocio Arjona,0,600,1,600,600,MINSA
Rocio Hernandez,1120,2760,3,3880,1293,Ministerio de la Presidencia
Rodney Mitre,0,3150,1,3150,3150,Ministerio del Ambiente
Rodolfo Aguilera,3710,4800,4,8510,2128,Ministerio de Seguridad Pública
Rodrigo Garcia,0,4400,4,4400,1100,Ministerio de Seguridad Pública
Rodrigo Guardia Dall'orso,0,315,1,315,315,MIVIOT
Rodrigo Ortiz,0,300,1,300,300,Ministerio de la Presidencia
Rogelio Alvarado,4036,4450,3,8486,2829,MEF
Rogelio Donadio,0,375,1,375,375,Ministerio de Seguridad Pública
Rogelio Medrano,1445,600,1,2045,2045,MEF
Rogelio Rodríguez,0,420,1,420,420,Ministerio del Ambiente
Rogelio Slopis,0,400,1,400,400,Ministerio del Ambiente
Rogelio Vásquez,440,1200,1,1640,1640,MEF
Roger Alexander,0,3000,1,3000,3000,Ministerio de Seguridad Pública
Roger Morales,0,400,1,400,400,Ministerio de Seguridad Pública
Rolando Becerra,0,300,1,300,300,Ministerio de Seguridad Pública
Rolando Fuentes,1241,4920,4,6161,1540,MITRADEL
Rolando Lopez,1467,0,1,1467,1467,Ministerio de la Presidencia
Rolando Luque,0,600,1,600,600,MINSA
Rolando Vásquez,0,4455,2,4455,2228,Ministerio del Ambiente
Roman Añino,0,1650,1,1650,1650,MINSA
Roman Ayala,0,400,1,400,400,Ministerio de Seguridad Pública
Romell Castillo,0,2400,1,2400,2400,Ministerio de Seguridad Pública
Ronald Campbell,5428,8000,4,13428,3357,Ministerio de la Presidencia
Ronald Vasquez,0,2400,1,2400,2400,Ministerio de Seguridad Pública
Roney Samaniego,0,9300,10,9300,930,Ministerio del Ambiente
Rorix Núñez,8831,59200,15,68031,4535,MITRADEL
Rosa Lowe,0,200,1,200,200,MINSA
Rosa Montero,0,400,1,400,400,MINSA
Roselin Roquebert,0,2100,1,2100,2100,Ministerio del Ambiente
Rosilena Lindo,0,36435,17,36435,2143,Ministerio del Ambiente
Rubén Herrera,0,2520,1,2520,2520,MEF
Ruben Ortiz,672,1600,1,2272,2272,Ministerio de la Presidencia
Ruben Pecchio,0,900,1,900,900,MINSA
Rubén Santos,0,420,1,420,420,Ministerio del Ambiente
Rubilú Rodríguez,0,1050,3,1050,350,MEF
Rufino Huertas,1115,2100,1,3215,3215,MIDES
Ruth Harding,1600,4000,2,5600,2800,MICI
Ruth Murillo,0,500,1,500,500,MINSA
Rutilio González,1871,5485,3,7356,2452,MITRADEL
S:e. Salazar,1120,3000,1,4120,4120,MICI
Salvador Sanchez,13598,9700,4,23298,5825,Ministerio de la Presidencia
Samantha Perez,0,2800,1,2800,2800,Ministerio del Ambiente
Samuel Moreno,7539,21800,8,29339,3667,MICI
Samuel Rivera,3953,6025,4,9978,2494,MITRADEL
Samuel Valdés,0,6810,4,6810,1703,Ministerio del Ambiente
Sandra Barrios,0,2250,1,2250,2250,Ministerio de la Presidencia
Sandra De Mendez,561,3150,1,3711,3711,Ministerio de la Presidencia
Sandra Ng,819,2970,2,3789,1894,MEF
Sandra Siu,4869,7800,2,12669,6335,MEF
Sandra Vega,0,0,1,0,0,MINSA
Santiago Noboa,1081,0,1,1081,1081,Ministerio de la Presidencia
Santiago Sanford,0,1400,1,1400,1400,MITRADEL
Saray Pimentel,0,630,1,630,630,MINSA
Saul Jordan,0,0,1,0,0,MOP
Selka Campos,0,0,1,0,0,MEF
Serafín Sánchez,0,0,1,0,0,MINSA
Sergio Gomez,3014,4670,3,7684,2561,Ministerio de la Presidencia
Sergio Vigil,0,0,1,0,0,MIDES
Shanida Navarro,1083,1050,1,2133,2133,MEF
Shanishka Johnson,0,3950,2,3950,1975,Ministerio de la Presidencia
Sharon Quinn,0,315,1,315,315,Ministerio del Ambiente
Sila Boya,0,900,2,900,450,Ministerio del Ambiente
Silvano Vergara,11289,16400,24,27689,1154,Ministerio del Ambiente
Silvia Batista,0,930,2,930,465,AIG
Soledad Batista,0,630,1,630,630,Ministerio del Ambiente
Sonia Gordon,0,1600,1,1600,1600,Ministerio de Seguridad Pública
Stella Escala,2651,3915,6,6566,1094,Ministerio de la Presidencia
Stephan Proaño,494,1600,1,2094,2094,MICI
Sugeidy Quintero,1073,4500,2,5573,2787,Ministerio de Seguridad Pública
Sugey Serrano,4540,13650,5,18190,3638,Ministerio de la Presidencia
Susana Calderon,1203,2800,2,4003,2001,Ministerio de la Presidencia
Sygrid Barragán,0,0,1,0,0,Ministerio del Ambiente
Tahira Benitez,1177,3150,2,4327,2163,MEF
Tamara Hernández,0,3360,2,3360,1680,Ministerio del Ambiente
Tatiana De Janon,1163,3350,3,4513,1504,MINSA
Tatina Nuñez,1031,0,1,1031,1031,Ministerio de la Presidencia
Temistocles Diaz,1819,3580,3,5399,1800,MINSA
Teresa Berbey,873,7050,1,7923,7923,MIVIOT
Tito González,5767,20200,7,25967,3710,MEF
Tulio Mosquera,0,2835,1,2835,2835,Ministerio del Ambiente
Valeriano Rodriguez,0,2400,1,2400,2400,Ministerio de Seguridad Pública
Valery González,0,1050,2,1050,525,MEF
Valia Sousa,0,405,1,405,405,Ministerio del Ambiente
Vanessa Tuñon,0,1260,1,1260,1260,Ministerio de la Presidencia
Vayron De Gracia,0,0,1,0,0,Ministerio del Ambiente
Velkis Afú,3125,6000,6,9125,1521,MICI
Vianka Aranda,1217,4200,1,5417,5417,MEF
Vicenta Rios,0,750,1,750,750,MINSA
Vicente Barletta,1446,1200,1,2646,2646,Ministerio de la Presidencia
Victor Corro,0,1770,4,1770,443,Ministerio del Ambiente
Victor Diaz,0,810,1,810,810,ANTAI
Victor Manuelsaturno,0,1500,1,1500,1500,Ministerio de Seguridad Pública
Víctor Medina,1779,4175,4,5954,1488,MEF
Victor Rodríguez,1311,2100,2,3411,1705,MEF
Victor Saturno,0,3000,1,3000,3000,Ministerio de Seguridad Pública
Victor Urrutia,13952,5800,10,19752,1975,Ministerio de la Presidencia
Vielka Tejada,1300,1785,3,3085,1028,MIDES
Vielka Vigil,3357,9780,5,13137,2627,MITRADEL
Virgilia Calderón,1848,2380,2,4228,2114,MEF
Virgilio Ureña,0,420,1,420,420,Ministerio del Ambiente
Virginia Muñoz,1577,400,1,1977,1977,MINSA
Viterbo Villarreal,2000,15640,8,17640,2205,Ministerio del Ambiente
Vivian Valdés,841,1125,1,1966,1966,MEF
Waldo Macre,3290,7650,3,10940,3647,Ministerio de la Presidencia
Walter Quintero,479,1200,1,1679,1679,MITRADEL
Wendy Herrera,0,525,1,525,525,Ministerio del Ambiente
Williams Robles,0,2000,2,2000,1000,Ministerio del Ambiente
Yadira Molto,0,400,2,400,200,MINSA
Yadira Rose,0,4000,1,4000,4000,Ministerio de Seguridad Pública
Yagehiry Garcia,0,630,1,630,630,Ministerio del Ambiente
Yahaira Cárdenas,0,4995,3,4995,1665,Ministerio del Ambiente
Yajaira Luna,0,810,2,810,405,Ministerio del Ambiente
Yalideth Gonzalez,0,1260,1,1260,1260,Ministerio de la Presidencia
Yamil Sánchez,0,630,2,630,315,Ministerio del Ambiente
Yamileth Diaz,585,3200,1,3785,3785,MOP
Yamileth Fajardo,0,450,1,450,450,Ministerio de la Presidencia
Yamileth Garrido,0,675,1,675,675,MINSA
Yaneth Jaramillo,1120,1200,1,2320,2320,Ministerio de la Presidencia
Yanileth Cedeño,0,540,1,540,540,MITRADEL
Yaoska Ruiz,950,1960,4,2910,728,Ministerio del Ambiente
Yaquelin Fossatti,0,1750,1,1750,1750,Ministerio del Ambiente
Yara González,7593,30215,8,37808,4726,MITRADEL
Yaremit Mendoza,0,6550,2,6550,3275,Ministerio del Ambiente
Yarianis Campos,1200,3150,1,4350,4350,MIDES
Yaribel Ruiz,2196,2400,1,4596,4596,MOP
Yariela Heart,0,300,1,300,300,MINSA
Yariela Ortega,0,0,1,0,0,MINSA
Yariseth Acevedo,0,3450,1,3450,3450,Ministerio del Ambiente
Yaritza Vallarino,0,1200,1,1200,1200,Ministerio de Seguridad Pública
Yasbeck Ramos,585,1800,1,2385,2385,MEF
Yasmín Cardenas,1200,6285,5,7485,1497,MIDES
Yasmira Rojas,0,1950,1,1950,1950,MINSA
Yatlin Ramos,1788,3990,3,5778,1926,MITRADEL
Yelkis Gill,0,750,1,750,750,MINSA
Yeny Carrasco,0,605,2,605,303,MINSA
Yessica Araúz,1391,4200,1,5591,5591,MEF
Yessica Martínez,0,1750,1,1750,1750,Ministerio del Ambiente
Yessika Arenas,2775,2700,1,5475,5475,Ministerio de la Presidencia
Yetzibel Pardo,980,1800,1,2780,2780,MEF
Yitza Batista,0,2400,1,2400,2400,Ministerio de Seguridad Pública
Yoani Gonzalez,0,2800,4,2800,700,MINSA
Yoaris Aparicio,0,420,1,420,420,Ministerio del Ambiente
Yoharis Boyce,0,4000,1,4000,4000,Ministerio de Seguridad Pública
Yolannie Núñez,1241,1500,1,2741,2741,MITRADEL
Yolany Castro,0,525,1,525,525,Ministerio del Ambiente
Yoleny Herrera,0,1440,1,1440,1440,MEF
Yuleika Cardenas,484,1200,1,1684,1684,Ministerio de la Presidencia
Yulissa Herrera,0,2415,1,2415,2415,MITRADEL
Yuriela Sagel,1316,2800,4,4116,1029,Ministerio de la Presidencia
Zaida Avila,0,3780,1,3780,3780,MEF
Zaida Reina,0,405,1,405,405,MINSA
Zeidy Llorente,0,300,1,300,300,Ministerio del Ambiente
Zelibeth Valverde,0,0,2,0,0,MINSA
Zereth Torres,6481,20500,10,26981,2698,MINSA
Zolinka Herrera,0,315,1,315,315,Ministerio del Ambiente
Zoraya Castrellon,0,3610,4,3610,903,Ministerio del Ambiente
Zoraya Quintero,6272,5850,2,12122,6061,Ministerio de la Presidencia
Zueline Aguilar,0,1200,1,1200,1200,AIG
Zuleika Arispe,0,3960,1,3960,3960,Ministerio del Ambiente
Zuleika Herbert,1500,945,2,2445,1223,MIDES
Zuleika Pinzón,0,10905,9,10905,1212,Ministerio del Ambiente
Zuleima Guillen,0,720,2,720,360,Ministerio del Ambiente
Zulema Sucre,5000,17120,11,22120,2011,MIDES
Zulma Rivera,0,2520,1,2520,2520,MEF
Zulphy Santamaría,7665,22265,8,29930,3741,MITRADEL
Zury Rios,644,0,1,644,644,Ministerio de la Presidencia